  NO    ./path_to_the_north_texture.xpm

		F 235,55,31
		C 78,78,78
     SO 											./path_to_the_south_texture.xpm
     WE 						./path_to_the_south_texture.xpm

	 EA 				./path_to_the_south_texture.xpm

11111
10E1111
1111111

