NO ./path_to_the_north_texture.xpm
WE ./path_to_the_south_texture.xpm
SO ./path_to_the_south_texture.xpm
EA ./path_to_the_south_texture.xpm
F 24,133,216
C 147,202,243


1111111111111111
1000100000000001
1110000000001111
1000000010000001
1000W001 10000001
1000000010000001
1000000000000001
1000000000000001
1000000000000001
1000000000000001
1111111111111111
