

             1
            1111111
           111110001
          100000111
         100000001
          1000001
           10001
        1111011
         1011   1
        1111111
        110WN001
        1010101
        1111111




                       



