NO ./textures/bluestone.xpm
SO ./textures/greystone.xpm
WE ./textures/eagle.xpm
EA ./textures/redbrick.xpm
F 24,133,216
C 147,202,243


111111
100001
100W01
10O001
100C01
111111