NO ./path_to_the_north_texture.xpm
WE ./path_to_the_south_texture.xpm
SO ./path_to_the_south_texture.xpm
EA ./path_to_the_south_texture.xpm
F 24,133,216
C 147,202,243


1111111111
100000W001
1000000001
1000100001
1111111111
