111111
100100001
101001
1100N1
111111
