  NO    ./path_to_the_north_texture.xpm

		F 24,133,216
		C 147,202,243
     WE 						./path_to_the_south_texture.xpm
     SO 				./path_to_the_south_texture.xpm


	 EA 				./path_to_the_south_texture.xpm
11111
1W0101111111
1001011
1111111	
1111111			
