



     NO    ./path_to_the_north_texture.xpm

		F grgegwe

     SO ./path_to_the_south_texture.xpm


             1				
            1111111				
           111110001				
          100000111				
         100000001				
          1000001				
           10001				
        1111111				


                  



