  NO    ./path_to_the_north_texture.xpm

		F 235,255,31
		C 78,78,78
     WE 						./path_to_the_south_texture.xpm
     SO 											./path_to_the_south_texture.xpm


	 EA 				./path_to_the_south_texture.xpm
11111
1W0101111111
1001011
1111111	
1111111			
