NO ./path_to_the_north_texture.xpm
WE ./path_to_the_south_texture.xpm
SO ./path_to_the_south_texture.xpm
EA ./path_to_the_south_texture.xpm
F 24,133,216
C 147,202,243


111111111111
100010000001
111000001111
100000000001
1000W0000001
100000000001
111111111111
